22222122222
29555555592
25666522252
15555P55551
25222522252
29555555592
22222122222